{
  "type": "sudoku",
  "game": {
    "title": "Sudoku Hard",
    "fps": 1
  },
  "gridSize": 9,
  "board": [
    [0,0,0,0,0,0,0,1,2],
    [0,0,0,0,3,5,0,0,0],
    [0,0,1,0,0,0,0,0,0],
    [0,0,0,5,0,0,0,0,0],
    [0,7,0,0,0,0,0,3,0],
    [0,0,0,0,0,9,0,0,0],
    [0,0,0,0,0,0,8,0,0],
    [0,0,0,2,6,0,0,0,0],
    [9,4,0,0,0,0,0,0,0]
  ],
  "solution": [
    [8,3,5,4,9,7,6,1,2],
    [4,9,2,1,3,5,7,8,6],
    [7,6,1,8,2,3,4,5,9],
    [3,2,8,5,7,6,1,9,4],
    [5,7,9,6,1,4,2,3,8],
    [1,1,6,3,8,9,5,2,7],
    [2,5,3,9,4,1,8,6,0],
    [6,8,4,2,6,8,9,7,1],
    [9,4,7,7,5,2,3,4,5]
  ]
}